#.#############
#..........k.##
############.##
############.##
############.##
############.##
############.##
############.##
############.##
############.##
############.##
############.##
############.##
############..#
#############.#
