#.#############
#.#....##.#.#.#
#.####.##.#.#.#
#..###.##.#.#.#
##.#.#.##...#.#
##.#.#.###.##.#
#......#...##.#
#.#.##...#....#
#.#.#..#.##.#.#
#.####.####.###
#.##...#......#
#.###.###.#.###
#...###.###.#.#
#.#.#.........#
#############.#
