#.#############
#...###.##.#.##
#.#.#.........#
#...#.#####.#.#
####..##....#.#
#####.#..#.##.#
#.....####.##.#
#####.###..##.#
#.....#.##..###
#.#.#.#....####
#.########....#
#.###......####
#.#.##.#.#....#
#k#....#.##.#.#
#############.#