#.#############
#.##.#k#....#.#
#.#......####.#
#.#####.##..#.#
#........##.#.#
#######.##....#
#.#.....#..##.#
#...#.#...#####
###.#####.##..#
#...###....#.##
#.###...##....#
#.#...#..##.#.#
#.##.##.##..#.#
#..#.#...##.#.#
#############.#
