#.#############
#......#k#.#..#
######.#.#.#.##
#.##.#.#.#.#..#
#......#.#...##
####.#.....#..#
#....###.###.##
########.###..#
##.###.....####
#......#.#..###
######.####...#
#.........##.##
###.##.####...#
#...#....##.#.#
#############.#
