#.#############
#..#.#....k.###
#......#.##..##
######.#.###..#
##.....###...##
#..###...##.###
##.##..#..#...#
#...##.########
#####.......###
#.....#######.#
##.##......#..#
##.#..######.##
#..##.#.......#
##..#.##.##.#.#
#############.#
