#..############
##.#..........#
#....#.#.#.#.##
##.#.#####.#..#
####....##.####
#....####...#.#
##.#....#.#...#
#..##.######.##
#.##..##.#.#..#
#..##......#.##
#.##..#.#######
#..##.#....##.#
##.##.##.#....#
#..k#.#..#.#.##
############..#
