#.#############
#.....#..##.#.#
##.##...###.#.#
#######.#.#.#.#
#.#.#...#.#.#.#
#.#.###.#.#.#.#
#.#.##..#.#.#.#
#...###.......#
#.#...#####.###
#####.#...#.#.#
#.......#.....#
######.####.#.#
##.....##...#.#
#..#.#.##k#.#.#
#############.#
