#.#############
#.#...##.k.#.##
#...#....###..#
###.#.##.###.##
#...#..###....#
#.#.##.....####
#.#.#..#.#....#
######.#.#.#.##
#......########
#.##.#..#.#.#.#
#######.......#
#..##.##.#.#.##
##.......######
###.##.#......#
#############.#
