#.#############
#.#.##..#..##.#
#....##...###.#
###.#####.....#
#...#.#.##.####
###.#.#.#.....#
#.#.....##.####
#...###....#.##
##.##...##....#
#..#######.####
####k####..#..#
#.#.....##.#.##
#.#####.#.....#
#.........#.#.#
#############.#
