#.#############
#..#..#.#.#.#.#
##.##...#.#.#.#
#...###...#...#
##.######.###.#
#...#.#.#.#.#.#
###.#.......#.#
#.....#####.#.#
##.#.##.....#.#
#..########.#.#
##.##..#......#
######.######.#
#.#.#.......#.#
#.....#.#.#..k#
#############.#
