#.#############
#..##.####.#..#
#.##...##..##.#
#.####..##.#..#
#.#....##....##
#.####..####..#
#.##.##.#.###.#
#...........#.#
###########...#
#k####......#.#
#....######.#.#
####.##.#.#.###
##...#........#
#..#...##.#.#.#
#############.#
