#.#############
#.#k.#.##..##.#
#.##....##..#.#
#.##.##.###.#.#
#.##.####.#...#
#.#...##..##.##
#.##.####.#...#
#.##..##....#.#
#..##.#..#.####
##.##.##.###.##
#......#......#
######...######
#....##.##.#.##
##.#..........#
#############.#
