#.#############
#..#.#.##.##.##
##.#.#.#...#..#
#..#.#...###.##
##...#.#####..#
####...###.#.##
#.####...#.#..#
#......###.#.##
######........#
#k.....#.######
###.##.#......#
#...#..#.###.##
#.#.##.####...#
#.#.#..##...#.#
#############.#
