#.#############
#.#.#.#.##....#
#.......#..####
#######.#.##.##
#####.........#
#.....#.#.###.#
#####.#.#...###
##.##.#.#.#...#
#.....#.#.#.#.#
##k#.##.###.###
#..#.####.....#
#.####.###.#.##
#.##.......#..#
#.##.##.##.##.#
#############.#
