#.......#######
#.#####....####
#.##...###.....
#.##.#.########
#....#.########
######.#k######
######...######
######.########
######.########
######.########
######.#.....##
######...###.##
##########...##
##########.####
##########....#